1111111111111
100100C0000C1
1C0F011111001
1P0011EFUCK!1
1111111111111
